1111111111111111111111111
100000000C000000000000001
100000000000000C000000001
10C1110000000010000000001
1000000000000010001111111
1000000000111110000000001
1000111100000000000010001
1000000100000000C00010001
100C000111111000000010001
1000000000001000000010001
100010000C00P00000C000001
10001000000010000000001E1
1000100000011111110000101
100C0000000000000000001C1
1111111111111111111111111