111111111111111111111111
1P00000011111110000000C1
11111110111E111011111111
1C0001000000000011111111
101111111111001111111111
1000C1C000000000000000C1
101111111111010111111111
1000V0000100010111100001
1111111101C1010000001101
1C0000000101C111C11C1101
111111110001111111111101
1C000000000000C000000001
111111111111111111111111