1111111111111111111111111
100000000C000000000000001
1000E0000000000C000000001
10C1110000000010000000001
1000000000000010001111111
1000000000111110000000001
1000111100000000000010001
1000000100000000C00010001
100C000111111000000010001
1000000000001000000010001
100010000C01P10000C000001
1000100000001000000000001
1000100000011111110000001
100C000000000000000000001
1111111111111111111111111